Туберкулез - хроническое инфекционное заболевание, вызываемое микобактериями, поражающее легкие и другие органы
Гепатит А - острая вирусная инфекция, передающаяся фекально-оральным путем, приводящая к воспалению печени
Гепатит B - хроническая вирусная инфекция, передающаяся через кровь и другие биологические жидкости, приводящая к воспалению и циррозу печени
Гепатит C - хроническая вирусная инфекция, передающаяся через кровь и другие биологические жидкости, приводящая к воспалению и раку печени
ВИЧ - вирус, поражающий иммунную систему человека, приводящий к снижению сопротивляемости организма различным инфекциям и опухолям
Дифтерия - острая бактериальная инфекция, поражающая слизистые оболочки дыхательных путей и вызывающая образование пленок, затрудняющих дыхание
Лепра - хроническое инфекционное заболевание, вызываемое микобактериями, поражающее кожу, нервы и другие органы, приводящее к утрате чувствительности и деформациям
Малярия - острая паразитарная инфекция, передающаяся укусами комаров, приводящая к лихорадке, анемии и нарушениям работы внутренних органов
Холера - острая бактериальная инфекция, передающаяся фекально-оральным путем, приводящая к тяжелому обезвоживанию организма из-за рвоты и поноса
Чума - острая бактериальная инфекция, передающаяся укусами блох или контактом с больными животными, приводящая к воспалению лимфатических узлов, сепсису и смерти
ОРВИ - острые респираторные вирусные инфекции, группа заболеваний, вызываемых различными вирусами, поражающихи дыхательные пути и сопровождающихся насморком, кашлем, головной болью и повышением температуры
ОРЗ - острые респираторные заболевания, группа заболеваний, вызываемых различными микроорганизмами (вирусы, бактерии, грибы), поражающих дыхательные пути и сопровождающихся насморком, кашлем, головной болью и повышением температуры
Анемия - состояние, характеризующееся снижением уровня гемоглобина и эритроцитов в крови, приводящее к кислородному голоданию тканей, слабости, утомляемости и бледности кожи
Энцефалит - воспаление головного мозга, вызываемое различными причинами (вирусы, бактерии, паразиты, аутоиммунные процессы), приводящее к нарушениям сознания, памяти, речи, движений и других функций
Бореллиоз - хроническое инфекционное заболевание, передающееся укусами клещей, вызываемое бактериями боррелия, поражающее кожу, суставы, нервную систему и сердце
Дизентерия - острая бактериальная инфекция, передающаяся фекально-оральным путем, приводящая к воспалению толстого кишечника, поносу с кровью и слизью, болям в животе и общему интоксикации организма
Сальмонеллез - острая бактериальная инфекция, передающаяся через недостаточно термически обработанные продукты животного происхождения, приводящая к тяжелому гастроэнтероколиту, рвоте, поносу, жару и обезвоживанию организма
Брюшной тиф - острая бактериальная инфекция, передающаяся фекально-оральным путем, приводящая к воспалению лимфатического аппарата тонкого кишечника, язвообразованию, кровотечениям, сепсису и тяжелому интоксикации организма
Гастроэнтерит - воспаление слизистой оболочки желудка и кишечника, вызываемое различными причинами (вирусы, бактерии, паразиты, аллергены, токсины), приводящее к нарушению пищеварения, рвоте, поносу, болям в животе и обезвоживанию организма
Ветряная оспа - острая вирусная инфекция, передающаяся воздушно-капельным путем, приводящая к появлению на коже и слизистых оболочках характерных пузырьков с прозрачным содержимым, сопровождающихся зудом и повышением температуры
Герпес - хроническая вирусная инфекция, передающаяся контактным путем, приводящая к появлению на коже и слизистых оболочках характерных групп пузырьков с прозрачным содержимым, сопровождающихся зудом и жжением
Псориаз - хроническое неинфекционное заболевание кожи, характеризующееся появлением на коже утолщенных, шелушащихся, воспаленных пятен, сопровождающихся зудом и дискомфортом
Свинка - острая вирусная инфекция, передающаяся воздушно-капельным путем, приводящая к воспалению околоушных слюнных желез, сопровождающемуся отеком, болями и повышением температуры
Корь - острая вирусная инфекция, передающаяся воздушно-капельным путем, приводящая к появлению на коже характерной сыпи, сопровождающейся кашлем, насморком, конъюнктивитом и повышением температуры
Краснуха - острая вирусная инфекция, передающаяся воздушно-капельным путем, приводящая к появлению на коже розовой сыпи, сопровождающейся увеличением лимфатических узлов и повышением температуры
Желтуха - состояние, характеризующееся окрашиванием кожи, слизистых оболочек и белков глаз в желтый цвет из-за повышения уровня билирубина в крови, которое может быть вызвано различными причинами, такими как воспаление печени, нарушение выделения желчи, гемолитическая анемия и др.
Опоясывающий лишай - хроническая вирусная инфекция, вызванная вирусом ветряной оспы, проявляющаяся в виде болезненных пузырьков на коже, расположенных по ходу нервных стволов
Вирусный гастроэнтерит (желудочный грипп) - острая вирусная инфекция, передающаяся фекально-оральным путем, приводящая к воспалению слизистой оболочки желудка и кишечника, сопровождающаяся рвотой, поносом, болями в животе и обезвоживанием организма
Инфекционный мононуклеоз - острая вирусная инфекция, передающаяся контактным путем, приводящая к увеличению лимфатических узлов, селезенки, печени, сопровождающаяся горловым синдромом, повышением температуры и общим интоксикацией организма
Вирус папилломы человека (ВПЧ) - группа вирусов, передающихся половым и контактным путем, приводящих к появлению на коже и слизистых оболочках различных новообразований, таких как бородавки, папилломы, кондиломы и др., некоторые из которых могут быть опасны для здоровья и жизни человека